--------------------------------
|..............................|
|..............................|
|....@..................:......|
|..............................|
|..............................|
|..............................|
|.........................*....|
----------+---------------------
          #                     
          #                     
        --+-------------------  
        |...............:..*.|  
        |....................|  
        |............%.......|  
        |................*...|  
        ----------------------  
