-----------         ------------
|.........|         |...,......|
|.........+#########+..........|
|.........|         |......@...|
|.........|         |..........|
|.........|         |..........|
|.........|         |..........|
|*........|         |......*...|
------+----         ------------
      #                         
      #         --------------  
      #         |...........*|  
      #         |............|  
      ##########+........:...|  
                |............|  
                --------------  
